0 0 0 0 0 0 0 0 0 0 0 0 0 0 0 0 0 0 0 0 0 0 0 0 
0 0 0 0 0 0 0 88 88 88 0 0 0 0 0 0 0 0 0 0 0 0 0 0 
0 0 0 0 0 0 0 88 0 88 88 88 88 88 88 88 88 88 0 0 0 0 0 0 
0 0 0 0 0 0 0 88 57 58 58 58 58 58 58 58 59 88 0 0 0 0 0 0 
0 0 0 0 0 0 0 88 61 62 62 62 62 62 62 62 63 88 0 0 0 0 0 0 
0 0 0 0 0 0 0 88 65 66 66 66 66 66 66 66 67 88 0 0 0 0 0 0 
0 0 0 0 0 0 0 88 8 9 9 9 9 9 9 9 10 88 0 0 0 0 0 0 
0 0 0 0 0 0 0 88 8 9 9 9 9 9 9 9 10 88 0 0 0 0 0 0 
0 0 0 0 0 0 0 88 8 9 9 9 9 9 9 9 10 88 0 0 0 0 0 0 
0 0 0 0 0 0 0 88 8 9 9 9 9 9 9 9 10 88 0 0 0 0 0 0 
0 0 0 0 0 0 0 88 8 9 9 9 9 9 9 9 10 88 0 0 0 0 0 0 
0 0 0 0 0 0 0 88 8 9 9 9 9 9 9 9 10 88 0 0 0 0 0 0 
0 0 0 0 0 0 0 88 88 88 88 88 88 88 88 88 88 88 0 0 0 0 0 0 
0 0 0 0 0 0 0 0 0 0 0 0 0 0 0 0 0 0 0 0 0 0 0 0 
0 0 0 0 0 0 0 0 0 0 0 0 0 0 0 0 0 0 0 0 0 0 0 0 
0 0 0 0 0 0 0 0 0 0 0 0 0 0 0 0 0 0 0 0 0 0 0 0 
