0 0 0 0 0 0 0 0 0 0 0 0 0 0 0 0 0 0 0 0 0 0 0 0 
0 0 0 0 0 0 0 0 0 0 0 0 0 0 0 0 0 0 0 0 0 0 0 0 
0 0 0 0 0 0 0 0 0 0 0 0 62 62 62 62 62 62 0 0 0 0 0 0 
0 0 0 0 0 0 0 0 0 0 0 0 62 62 62 62 62 62 0 0 0 0 0 0 
0 0 0 0 0 0 0 0 0 0 0 0 62 62 62 62 62 62 0 0 0 0 0 0 
0 0 0 0 0 0 0 0 0 0 0 0 62 62 62 62 62 62 0 0 0 0 0 0 
0 0 0 0 0 0 62 62 62 62 62 62 9 9 9 9 9 9 0 0 0 0 0 0 
0 0 0 0 0 0 62 62 62 62 62 62 9 9 9 9 9 9 0 0 0 0 0 0 
0 0 0 0 0 0 62 62 62 62 62 62 174 175 175 176 9 9 0 0 0 0 0 0 
0 0 0 0 0 0 9 9 9 9 9 9 9 9 9 9 9 9 0 0 0 0 0 0 
0 0 0 0 0 0 9 9 9 9 9 9 9 9 9 9 9 9 0 0 0 0 0 0 
0 0 0 0 0 0 9 9 9 9 9 9 9 9 9 9 9 9 0 0 0 0 0 0 
0 0 0 0 0 0 0 0 0 9 9 9 0 0 0 0 0 0 0 0 0 0 0 0 
0 0 0 0 0 0 0 0 0 0 0 0 0 0 0 0 0 0 0 0 0 0 0 0 
0 0 0 0 0 0 0 0 0 0 0 0 0 0 0 0 0 0 0 0 0 0 0 0 
0 0 0 0 0 0 0 0 0 0 0 0 0 0 0 0 0 0 0 0 0 0 0 0 
