0 0 0 0 0 0 0 0 0 0 0 0 0 0 0 0 0 0 0 0 0 0 0 0 
0 0 0 0 0 0 0 0 0 0 0 0 0 0 0 0 0 0 0 0 0 0 0 0 
0 0 0 0 0 0 0 57 58 58 58 58 58 58 58 58 59 0 0 0 0 0 0 0 
0 0 0 0 0 0 0 61 62 62 62 62 62 62 62 62 63 0 0 0 0 0 0 0 
0 0 0 0 0 0 0 61 62 62 62 62 62 62 62 0 63 0 0 0 0 0 0 0 
0 0 0 0 0 0 0 1 2 2 2 2 2 2 2 2 3 0 0 0 0 0 0 0 
0 0 0 0 0 0 0 8 9 9 9 0 9 9 9 9 10 0 0 0 0 0 0 0 
0 0 0 0 0 0 0 8 9 9 0 9 9 9 9 9 10 0 0 0 0 0 0 0 
0 0 0 0 0 0 0 8 0 9 9 9 9 9 9 9 10 0 0 0 0 0 0 0 
0 0 0 0 0 0 0 8 9 9 9 9 9 9 9 9 10 0 0 0 0 0 0 0 
0 0 0 0 0 0 0 15 16 5 9 4 16 16 16 16 17 0 0 0 0 0 0 0 
0 0 0 0 0 0 0 0 0 15 16 17 0 0 0 0 0 0 0 0 0 0 0 0 
0 0 0 0 0 0 0 0 0 0 0 0 0 0 0 0 0 0 0 0 0 0 0 0 
0 0 0 0 0 0 0 0 0 0 0 0 0 0 0 0 0 0 0 0 0 0 0 0 
0 0 0 0 0 0 0 0 0 0 0 0 0 0 0 0 0 0 0 0 0 0 0 0 
0 0 0 0 0 0 0 0 0 0 0 0 0 0 0 0 0 0 0 0 0 0 0 0 
