0 0 0 0 0 0 0 0 0 0 0 0 0 0 0 0 0 0 0 0 0 0 0 0 
0 0 0 0 0 0 0 0 0 0 0 0 0 0 0 0 0 0 0 0 0 0 0 0 
0 0 0 0 0 0 0 0 0 0 0 0 0 0 0 0 0 0 0 0 0 0 0 0 
0 0 0 0 0 73 62 74 62 62 62 62 62 62 75 62 62 76 62 62 0 0 0 0 
0 0 0 0 0 62 62 62 74 74 62 75 62 76 62 76 62 62 62 62 0 0 0 0 
0 0 0 0 0 62 74 62 73 62 73 74 75 75 74 74 75 74 62 62 0 0 0 0 
0 0 0 0 0 62 74 62 75 62 76 75 62 73 75 74 76 62 76 62 0 0 0 0 
0 0 0 0 0 9 9 9 9 9 9 9 9 9 9 9 9 9 9 9 0 0 0 0 
0 0 0 0 0 9 9 30 9 9 31 9 32 45 9 7 9 37 9 9 0 0 0 0 
0 0 0 0 0 9 30 9 14 44 9 9 9 38 9 9 45 9 9 9 0 0 0 0 
0 0 0 0 0 9 9 51 9 9 52 9 53 9 9 9 9 9 9 9 0 0 0 0 
0 0 0 0 0 0 0 0 0 0 0 0 0 0 0 0 0 0 0 0 0 0 0 0 
0 0 0 0 0 0 0 0 0 0 0 0 0 0 0 0 0 0 0 0 0 0 0 0 
0 0 0 0 0 0 0 0 0 0 0 0 0 0 0 0 0 0 0 0 0 0 0 0 
0 0 0 0 0 0 0 0 0 0 0 0 0 0 0 0 0 0 0 0 0 0 0 0 
0 0 0 0 0 0 0 0 0 0 0 0 0 0 0 0 0 0 0 0 0 0 0 0 
