0 0 0 0 0 0 0 0 0 0 0 0 0 0 0 0 0 0 0 0 0 0 0 0 
0 0 0 0 0 0 0 0 0 0 0 0 0 0 0 0 0 0 0 0 0 0 0 0 
0 0 0 0 0 0 0 0 57 58 58 58 58 58 58 59 0 0 0 0 0 0 0 0 
0 0 0 0 0 0 0 0 61 62 62 62 62 62 62 63 0 0 0 0 0 0 0 0 
0 0 0 0 0 0 0 0 61 62 62 62 62 62 62 63 0 0 0 0 0 0 0 0 
0 0 0 0 0 0 0 0 61 62 62 62 62 62 62 63 0 0 0 0 0 0 0 0 
0 0 0 0 0 0 0 0 1 2 2 2 2 2 2 3 0 0 0 0 0 0 0 0 
0 0 0 0 0 0 0 0 8 9 9 9 9 9 9 10 0 0 0 0 0 0 0 0 
0 0 0 0 0 0 0 0 8 9 9 9 9 9 9 10 0 0 0 0 0 0 0 0 
0 0 0 0 0 0 0 0 8 9 9 9 9 9 9 10 0 0 0 0 0 0 0 0 
0 0 0 0 0 0 0 0 8 9 9 9 9 9 9 10 0 0 0 0 0 0 0 0 
0 0 0 0 0 0 0 0 8 9 9 9 9 9 9 10 0 0 0 0 0 0 0 0 
0 0 0 0 0 0 0 0 0 0 0 0 0 0 0 0 0 0 0 0 0 0 0 0 
0 0 0 0 0 0 0 0 0 0 0 0 0 0 0 0 0 0 0 0 0 0 0 0 
0 0 0 0 0 0 0 0 0 0 0 0 0 0 0 0 0 0 0 0 0 0 0 0 
0 0 0 0 0 0 0 0 0 0 0 0 0 0 0 0 0 0 0 0 0 0 0 0 
