0 0 0 0 0 0 0 0 0 0 0 0 0 0 0 0 0 0 0 0 0 0 0 0 
0 0 0 0 0 0 0 88 88 88 88 88 88 88 88 0 0 0 0 0 0 0 0 0 
0 0 0 0 0 0 0 88 88 84 94 94 94 85 88 0 0 0 0 0 0 0 0 0 
0 0 0 0 0 0 0 0 88 89 0 0 0 87 88 0 0 0 0 0 0 0 0 0 
0 0 0 0 0 0 0 0 88 89 0 0 0 87 88 0 0 0 0 0 0 0 0 0 
0 0 0 0 0 0 0 0 88 89 0 0 0 87 88 0 0 0 0 0 0 0 0 0 
0 0 0 0 0 0 0 88 88 89 0 0 0 87 88 0 0 0 0 0 0 0 0 0 
0 0 0 0 0 0 0 88 88 89 0 0 0 87 88 0 0 0 0 0 0 0 0 0 
0 0 0 0 0 0 0 88 88 89 0 0 0 87 88 0 0 0 0 0 0 0 0 0 
0 0 0 0 0 0 0 0 88 89 0 0 0 87 88 0 0 0 0 0 0 0 0 0 
0 0 0 0 0 0 0 0 88 90 82 82 82 91 88 0 0 0 0 0 0 0 0 0 
0 0 0 0 0 0 0 0 88 88 88 88 88 88 88 0 0 0 0 0 0 0 0 0 
0 0 0 0 0 0 0 0 0 0 0 0 0 0 0 0 0 0 0 0 0 0 0 0 
0 0 0 0 0 0 0 0 0 0 0 0 0 0 0 0 0 0 0 0 0 0 0 0 
0 0 0 0 0 0 0 0 0 0 0 0 0 0 0 0 0 0 0 0 0 0 0 0 
0 0 0 0 0 0 0 0 0 0 0 0 0 0 0 0 0 0 0 0 0 0 0 0 
